+--+--+--+--+
|R     |   g|
+  +--+  +  +
|  |     |  |
+  +  +--+  +
|     |     |
+--+  +  +--+
|        |  |
+--+--+--+--+
