+--+--+--+--+--+--+
|     C     |   C |
+  +--+  +--+  +  +
|  |     |  |     |
+  +  +--+  +--+  +
|  |  C     |  |  |
+  +--+  +--+  +  +
|     R  |     C  |
+  +--+--+--+--+  +
|                 G
+--+--+--+--+--+--+
