+--+--+--+--+
|           |
+  +--+  +  +
|  |     |  |
+  +  +--+  +
|  |     C  |
+  +--+--+  +
|     R  |  G
+--+--+--+--+