+--+--+--+--+
|           |
+  +--+  +  +
|  |     |  |
+  +  +--+--+
|  |     C  |
+  +--+--+  +
|     R  | g|
+--+--+--+--+