+--+--+--+--+
|         C |
+  +--+  +  +
|  |     |  |
+  +  +--+--+
|  |     C  |
+  +--+--+  +
|     R  |  G
+--+--+--+--+
