+--+--+--+--+--+--+--+--+
|  C     |     C  |     |
+  +  +--+  +--+  +  +  +
|  |  |     |     |  |  |
+  +  +  +--+--+  +  +  +
|     |  C  |  C  |     |
+--+  +--+  +  +--+  +--+
|     |     R     |     |
+  +--+  +--+--+  +--+  +
|  |  |     |     |  |  |
+  +  +--+  +  +--+  +  +
|     C     |     C     |
+  +--+--+--+--+--+--+  +
|                       G
+--+--+--+--+--+--+--+--+
