+--+--+--+--+--+--+
|        R        G
+  +--+--+--+--+  +
|  |  C        |  |
+  +  +--+--+  +  +
|     |     |     |
+--+  +     +  +--+
|     |     |     |
+  +  +--+--+  +  +
|  |        C  |  |
+  +--+--+--+--+  +
|                 |
+--+--+--+--+--+--+
